11111111
10000PC1
11011111
10000E01
11111111