1111111111111
10000000C0001
1001011111111
10010001C0001
100100c000001
1000111110111
1P011E00000C1
1111111111111